********************************
*            MMTTMM            *
*            CRRRRC            *
*       *              *       *
*       *              *       *
*       *              *       *
*       *              *       *
*       *              *       *
*       *              *       *
*       *              *       *
*                              *
*                              *
*       *              *       *
*       *              *       *
*       *              *       *
*       *              *       *
*       *              *       *
*       *              *       *
*       *              *       *
*                              *
*                              *
*       *              *       *
*       *              *       *
*       *              *       *
*       *              *       *
*       *              *       *
*       *              *       *
*       *              *       *
*       *              *       *
*            MMTTMM            *
*            CRRRRC            *
********************************